grid1 = [
    [1,1,1,1,1,1,1,1,1,1],
    [1,0,0,0,0,0,1,0,0,1],
    [1,0,1,1,1,0,1,0,1,1],
    [1,0,1,0,0,0,0,0,0,1],
    [1,0,0,0,1,1,1,1,0,1],
    [1,1,1,0,0,0,0,0,0,1],
    [1,1,1,1,1,1,1,1,1,1],
]
start1 = (1, 1)
goal1  = (5, 8)
