##########
#S....#..#
#.###.#.##
#.#......#
#...####.#
###.....G#
##########
