grid2 = [
    [1,1,1,1,1,1,1,1,1,1,1,1,1],
    [1,0,0,0,1,0,0,0,0,0,1,0,1],
    [1,0,1,0,1,0,1,1,1,0,1,0,1],
    [1,0,1,0,0,0,0,0,1,0,0,0,1],
    [1,0,1,1,1,1,1,0,1,1,1,0,1],
    [1,0,0,0,0,0,1,0,0,0,1,0,1],
    [1,1,1,1,1,0,1,1,1,0,1,0,1],
    [1,0,0,0,1,0,0,0,1,0,0,0,1],
    [1,0,1,0,1,1,1,0,1,1,1,0,1],
    [1,0,1,0,0,0,0,0,0,0,1,0,1],
    [1,0,1,1,1,1,1,1,1,0,1,0,1],
    [1,0,0,0,0,0,0,0,1,0,0,0,1],
    [1,1,1,1,1,1,1,1,1,1,1,1,1],
]
start2 = (1, 1)
goal2  = (11, 11)
