###############
#S#.....#.....#
#.#.###.#.###.#
#.#...#.#...#.#
#.###.#.###.#.#
#.....#.....#G#
###############
