####################
#S....#...........##
#.###.#.#########..#
#...#.#.....#......#
###.#.#####.#.######
#...#.....#.#......#
#.#######.#.######.#
#.........#......#G#
####################
